order date,buyer name,buyer email,buyer phone,buyer note,ship to name,ship to street,ship to street 2,ship to city,ship to state,ship to zip,ship to country,item type,item name,package,option,artist,upc,isrc,item price,quantity,discount code,currency,sub total,tax,shipping,assessed revenue share,collected revenue share,balance of revenue share,paypal fee,item total,amount received,paypal transaction id,net amount,ship date,ship notes,item url,country,region/state,city,referrer,referrer url
1/1/14 12:10am,Some guy,eck@live.com,,,,,,,,,,track,Till It's Over,digital download,,Tristam,,,1.29,1,,CAD,1.29,,,0.13,0,1.26,*,1.29,1.29,7YN66058PV864574Y,1.16,,,http://music.monstercat.com/track/till-its-over,United States,HI,Honolulu,,
1/1/14 1:10am,Someone Else,urban@gmail.com,,,,,,,,,,album,Destination: Apollo,digital download,,Astronaut,,,6.66,1,,CAD,6.66,,,0.67,0,1.93,*,6.66,6.66,5TM73086R28292517,5.99,,,http://music.monstercat.com/album/destination-apollo,United States,TX,Fort Worth,music.monstercat.com,music.monstercat.com
1/1/14 1:11am,David,spirit@aol.com,,,,,,,,,,track,Till It's Over,digital download,,Tristam,,,1.29,1,,CAD,1.29,,,0.13,0,2.06,*,1.29,1.29,8EG200711K648800J,1.16,,,http://music.monstercat.com/track/till-its-over,United States,AL,Huntsville,,
1/1/14 1:30am,E Z ,abc@gmail.com,,,,,,,,,,track,Till It's Over,digital download,,Tristam,,,1.4,10,,CAD,1.4,,,0.14,0,2.2,*,1.4,1.4,7H908876C6891750G,1.26,,,http://music.monstercat.com/track/till-its-over,United States,TX,Killeen,www.youtube.com,www.youtube.com/redirect?q=http%3A%2F%2Fmonster.cat%2F1fWR8BQ&session_token=R1ySX1Sdr3axTQhQ6oe_QljJYrR8MTM4ODYyNDMxN0AxMzg4NTM3OTE3
1/1/14 1:47am,Nope,cough@yahoo.com,,,,,,,,,,track,Till It's Over,digital download,,Tristam,,,1.29,1,,CAD,1.29,,,0.13,1.29,1.04,,1.29,0,<-- collected to cover your revenue share balance,1.16,,,http://music.monstercat.com/track/till-its-over,United States,TN,Jackson,,
1/1/14 1:52am,Cool guy,dan@hotmail.com,,,,,,,,,,track,The Scarlet Dawn,digital download,,Varien,,,1.29,1,,CAD,1.29,,,0.13,0,1.17,*,1.29,1.29,3LT09089D10186849,1.16,,,http://music.monstercat.com/track/the-scarlet-dawn,Canada,BC,Burnaby,YouTube,www.youtube.com/watch?v=fyCKoJzKnz8
